WWWWWWWWWWW
W O Z Z J W
WWWWWWWWWWW

     WWW
WWWWWWZWWWWWWW
W J B O H    V
WWWWWWWWWWWWWW

      WWW
WWWWWWWZWWWW
WJ  D B OBSW
WWWWWWWWWWWW

   WWW
WWWWZWWWW
WV  O  VW
WWWWJWWWW
   WWW

